Feature	T2DM_combined	T2DM_SGMP	T2DM_GGMP
"k__Archaea;p__Euryarchaeota;c__Methanobacteria;o__Methanobacteriales;f__Methanobacteriaceae;g__Methanobrevibacter"	FALSE	FALSE	FALSE
"k__Bacteria;p__Actinobacteria;c__Actinobacteria;o__Actinomycetales;f__Brevibacteriaceae;g__Brevibacterium"	FALSE	FALSE	FALSE
"k__Bacteria;p__Actinobacteria;c__Actinobacteria;o__Bifidobacteriales;f__Bifidobacteriaceae;g__Bifidobacterium"	TRUE	TRUE	TRUE
"k__Bacteria;p__Actinobacteria;c__Coriobacteriia;o__Coriobacteriales;f__Coriobacteriaceae;g__Atopobium"	FALSE	FALSE	FALSE
"k__Bacteria;p__Actinobacteria;c__Coriobacteriia;o__Coriobacteriales;f__Coriobacteriaceae;g__Collinsella"	TRUE	TRUE	FALSE
"k__Bacteria;p__Actinobacteria;c__Coriobacteriia;o__Coriobacteriales;f__Coriobacteriaceae;g__Eggerthella"	FALSE	FALSE	FALSE
"k__Bacteria;p__Bacteroidetes;c__ Saprospirae ;o__ Saprospirales ;f__Chitinophagaceae;g__"	FALSE	FALSE	FALSE
"k__Bacteria;p__Bacteroidetes;c__ Saprospirae ;o__ Saprospirales ;f__Chitinophagaceae;g__Sediminibacterium"	FALSE	FALSE	FALSE
"k__Bacteria;p__Bacteroidetes;c__Bacteroidia;o__Bacteroidales;f__ Barnesiellaceae ;g__"	FALSE	FALSE	TRUE
"k__Bacteria;p__Bacteroidetes;c__Bacteroidia;o__Bacteroidales;f__ Barnesiellaceae ;g__Barnesiella"	FALSE	TRUE	FALSE
"k__Bacteria;p__Bacteroidetes;c__Bacteroidia;o__Bacteroidales;f__ Odoribacteraceae ;g__Butyricimonas"	FALSE	TRUE	TRUE
"k__Bacteria;p__Bacteroidetes;c__Bacteroidia;o__Bacteroidales;f__ Odoribacteraceae ;g__Odoribacter"	FALSE	FALSE	TRUE
"k__Bacteria;p__Bacteroidetes;c__Bacteroidia;o__Bacteroidales;f__ Paraprevotellaceae ;g__"	FALSE	TRUE	FALSE
"k__Bacteria;p__Bacteroidetes;c__Bacteroidia;o__Bacteroidales;f__ Paraprevotellaceae ;g__ Prevotella "	FALSE	TRUE	FALSE
"k__Bacteria;p__Bacteroidetes;c__Bacteroidia;o__Bacteroidales;f__Bacteroidaceae;g__Bacteroides"	FALSE	TRUE	TRUE
"k__Bacteria;p__Bacteroidetes;c__Bacteroidia;o__Bacteroidales;f__Porphyromonadaceae;g__Parabacteroides"	TRUE	TRUE	FALSE
"k__Bacteria;p__Bacteroidetes;c__Bacteroidia;o__Bacteroidales;f__Porphyromonadaceae;g__Porphyromonas"	FALSE	FALSE	FALSE
"k__Bacteria;p__Bacteroidetes;c__Bacteroidia;o__Bacteroidales;f__Prevotellaceae;g__Prevotella"	FALSE	TRUE	FALSE
"k__Bacteria;p__Bacteroidetes;c__Bacteroidia;o__Bacteroidales;f__Rikenellaceae;g__"	FALSE	FALSE	TRUE
"k__Bacteria;p__Bacteroidetes;c__Bacteroidia;o__Bacteroidales;f__S24-7;g__"	FALSE	TRUE	FALSE
"k__Bacteria;p__Cyanobacteria;c__4C0d-2;o__YS2;f__;g__"	FALSE	TRUE	FALSE
"k__Bacteria;p__Cyanobacteria;c__Chloroplast;o__Streptophyta;f__;g__"	FALSE	FALSE	FALSE
"k__Bacteria;p__Firmicutes;c__Bacilli;o__Lactobacillales;f__Lactobacillaceae;g__Lactobacillus"	TRUE	TRUE	TRUE
"k__Bacteria;p__Firmicutes;c__Bacilli;o__Lactobacillales;f__Streptococcaceae;g__Streptococcus"	FALSE	TRUE	FALSE
"k__Bacteria;p__Firmicutes;c__Bacilli;o__Turicibacterales;f__Turicibacteraceae;g__Turicibacter"	FALSE	TRUE	FALSE
"k__Bacteria;p__Firmicutes;c__Clostridia;o__Clostridiales;f__ Tissierellaceae ;g__WAL_1855D"	FALSE	FALSE	TRUE
"k__Bacteria;p__Firmicutes;c__Clostridia;o__Clostridiales;f__;g__"	TRUE	TRUE	TRUE
"k__Bacteria;p__Firmicutes;c__Clostridia;o__Clostridiales;f__Christensenellaceae;g__"	FALSE	TRUE	FALSE
"k__Bacteria;p__Firmicutes;c__Clostridia;o__Clostridiales;f__Clostridiaceae;g__"	TRUE	FALSE	TRUE
"k__Bacteria;p__Firmicutes;c__Clostridia;o__Clostridiales;f__Clostridiaceae;g__Clostridium"	TRUE	FALSE	FALSE
"k__Bacteria;p__Firmicutes;c__Clostridia;o__Clostridiales;f__Clostridiaceae;g__SMB53"	FALSE	TRUE	TRUE
"k__Bacteria;p__Firmicutes;c__Clostridia;o__Clostridiales;f__Lachnospiraceae;g__"	TRUE	FALSE	TRUE
"k__Bacteria;p__Firmicutes;c__Clostridia;o__Clostridiales;f__Lachnospiraceae;g__ Ruminococcus "	FALSE	TRUE	FALSE
"k__Bacteria;p__Firmicutes;c__Clostridia;o__Clostridiales;f__Lachnospiraceae;g__Anaerostipes"	FALSE	TRUE	TRUE
"k__Bacteria;p__Firmicutes;c__Clostridia;o__Clostridiales;f__Lachnospiraceae;g__Blautia"	TRUE	TRUE	FALSE
"k__Bacteria;p__Firmicutes;c__Clostridia;o__Clostridiales;f__Lachnospiraceae;g__Clostridium"	FALSE	TRUE	FALSE
"k__Bacteria;p__Firmicutes;c__Clostridia;o__Clostridiales;f__Lachnospiraceae;g__Coprococcus"	TRUE	TRUE	TRUE
"k__Bacteria;p__Firmicutes;c__Clostridia;o__Clostridiales;f__Lachnospiraceae;g__Dorea"	TRUE	TRUE	FALSE
"k__Bacteria;p__Firmicutes;c__Clostridia;o__Clostridiales;f__Lachnospiraceae;g__Lachnobacterium"	TRUE	TRUE	FALSE
"k__Bacteria;p__Firmicutes;c__Clostridia;o__Clostridiales;f__Lachnospiraceae;g__Lachnospira"	FALSE	TRUE	FALSE
"k__Bacteria;p__Firmicutes;c__Clostridia;o__Clostridiales;f__Lachnospiraceae;g__Roseburia"	TRUE	TRUE	FALSE
"k__Bacteria;p__Firmicutes;c__Clostridia;o__Clostridiales;f__Ruminococcaceae;g__"	FALSE	TRUE	FALSE
"k__Bacteria;p__Firmicutes;c__Clostridia;o__Clostridiales;f__Ruminococcaceae;g__Anaerotruncus"	FALSE	FALSE	FALSE
"k__Bacteria;p__Firmicutes;c__Clostridia;o__Clostridiales;f__Ruminococcaceae;g__Butyricicoccus"	FALSE	FALSE	TRUE
"k__Bacteria;p__Firmicutes;c__Clostridia;o__Clostridiales;f__Ruminococcaceae;g__Faecalibacterium"	TRUE	TRUE	TRUE
"k__Bacteria;p__Firmicutes;c__Clostridia;o__Clostridiales;f__Ruminococcaceae;g__Gemmiger"	FALSE	FALSE	FALSE
"k__Bacteria;p__Firmicutes;c__Clostridia;o__Clostridiales;f__Ruminococcaceae;g__Oscillospira"	TRUE	TRUE	TRUE
"k__Bacteria;p__Firmicutes;c__Clostridia;o__Clostridiales;f__Ruminococcaceae;g__Ruminococcus"	TRUE	TRUE	FALSE
"k__Bacteria;p__Firmicutes;c__Clostridia;o__Clostridiales;f__Ruminococcaceae;g__Subdoligranulum"	TRUE	TRUE	FALSE
"k__Bacteria;p__Firmicutes;c__Clostridia;o__Clostridiales;f__Veillonellaceae;g__Acidaminococcus"	FALSE	TRUE	FALSE
"k__Bacteria;p__Firmicutes;c__Clostridia;o__Clostridiales;f__Veillonellaceae;g__Dialister"	TRUE	TRUE	FALSE
"k__Bacteria;p__Firmicutes;c__Clostridia;o__Clostridiales;f__Veillonellaceae;g__Megamonas"	TRUE	TRUE	FALSE
"k__Bacteria;p__Firmicutes;c__Clostridia;o__Clostridiales;f__Veillonellaceae;g__Megasphaera"	TRUE	TRUE	TRUE
"k__Bacteria;p__Firmicutes;c__Clostridia;o__Clostridiales;f__Veillonellaceae;g__Phascolarctobacterium"	FALSE	TRUE	FALSE
"k__Bacteria;p__Firmicutes;c__Clostridia;o__Clostridiales;f__Veillonellaceae;g__Veillonella"	FALSE	TRUE	FALSE
"k__Bacteria;p__Firmicutes;c__Erysipelotrichi;o__Erysipelotrichales;f__Erysipelotrichaceae;g__"	TRUE	TRUE	TRUE
"k__Bacteria;p__Firmicutes;c__Erysipelotrichi;o__Erysipelotrichales;f__Erysipelotrichaceae;g__ Eubacterium "	FALSE	TRUE	FALSE
"k__Bacteria;p__Firmicutes;c__Erysipelotrichi;o__Erysipelotrichales;f__Erysipelotrichaceae;g__Catenibacterium"	FALSE	FALSE	TRUE
"k__Bacteria;p__Firmicutes;c__Erysipelotrichi;o__Erysipelotrichales;f__Erysipelotrichaceae;g__Clostridium"	FALSE	FALSE	FALSE
"k__Bacteria;p__Firmicutes;c__Erysipelotrichi;o__Erysipelotrichales;f__Erysipelotrichaceae;g__Coprobacillus"	FALSE	FALSE	FALSE
"k__Bacteria;p__Firmicutes;c__Erysipelotrichi;o__Erysipelotrichales;f__Erysipelotrichaceae;g__Holdemania"	FALSE	FALSE	FALSE
"k__Bacteria;p__Fusobacteria;c__Fusobacteriia;o__Fusobacteriales;f__Fusobacteriaceae;g__Fusobacterium"	TRUE	TRUE	FALSE
"k__Bacteria;p__Proteobacteria;c__Alphaproteobacteria;o__Caulobacterales;f__Caulobacteraceae;g__"	FALSE	FALSE	FALSE
"k__Bacteria;p__Proteobacteria;c__Alphaproteobacteria;o__RF32;f__;g__"	FALSE	TRUE	FALSE
"k__Bacteria;p__Proteobacteria;c__Alphaproteobacteria;o__Rhizobiales;f__Bradyrhizobiaceae;g__Bradyrhizobium"	TRUE	FALSE	FALSE
"k__Bacteria;p__Proteobacteria;c__Alphaproteobacteria;o__Rhizobiales;f__Hyphomicrobiaceae;g__Devosia"	FALSE	FALSE	TRUE
"k__Bacteria;p__Proteobacteria;c__Alphaproteobacteria;o__Rhizobiales;f__Methylobacteriaceae;g__Methylobacterium"	FALSE	FALSE	TRUE
"k__Bacteria;p__Proteobacteria;c__Alphaproteobacteria;o__Sphingomonadales;f__Sphingomonadaceae;g__Sphingomonas"	FALSE	FALSE	FALSE
"k__Bacteria;p__Proteobacteria;c__Betaproteobacteria;o__Burkholderiales;f__Alcaligenaceae;g__Sutterella"	TRUE	TRUE	FALSE
"k__Bacteria;p__Proteobacteria;c__Betaproteobacteria;o__Burkholderiales;f__Comamonadaceae;g__Comamonas"	FALSE	FALSE	FALSE
"k__Bacteria;p__Proteobacteria;c__Betaproteobacteria;o__Burkholderiales;f__Oxalobacteraceae;g__Herbaspirillum"	FALSE	FALSE	TRUE
"k__Bacteria;p__Proteobacteria;c__Betaproteobacteria;o__Burkholderiales;f__Oxalobacteraceae;g__Oxalobacter"	FALSE	FALSE	FALSE
"k__Bacteria;p__Proteobacteria;c__Betaproteobacteria;o__Burkholderiales;f__Oxalobacteraceae;g__Ralstonia"	FALSE	FALSE	TRUE
"k__Bacteria;p__Proteobacteria;c__Deltaproteobacteria;o__Desulfovibrionales;f__Desulfovibrionaceae;g__Bilophila"	FALSE	TRUE	FALSE
"k__Bacteria;p__Proteobacteria;c__Deltaproteobacteria;o__Desulfovibrionales;f__Desulfovibrionaceae;g__Desulfovibrio"	FALSE	TRUE	FALSE
"k__Bacteria;p__Proteobacteria;c__Gammaproteobacteria;o__Enterobacteriales;f__Enterobacteriaceae;g__Citrobacter"	FALSE	TRUE	FALSE
"k__Bacteria;p__Proteobacteria;c__Gammaproteobacteria;o__Enterobacteriales;f__Enterobacteriaceae;g__Shigella"	TRUE	TRUE	FALSE
"k__Bacteria;p__Proteobacteria;c__Gammaproteobacteria;o__Pasteurellales;f__Pasteurellaceae;g__Haemophilus"	FALSE	TRUE	TRUE
"k__Bacteria;p__Proteobacteria;c__Gammaproteobacteria;o__Pseudomonadales;f__Moraxellaceae;g__Acinetobacter"	FALSE	FALSE	FALSE
"k__Bacteria;p__Proteobacteria;c__Gammaproteobacteria;o__Pseudomonadales;f__Moraxellaceae;g__Psychrobacter"	FALSE	FALSE	TRUE
"k__Bacteria;p__Synergistetes;c__Synergistia;o__Synergistales;f__Dethiosulfovibrionaceae;g__Pyramidobacter"	FALSE	FALSE	FALSE
"k__Bacteria;p__Tenericutes;c__Mollicutes;o__RF39;f__;g__"	FALSE	TRUE	FALSE
"k__Bacteria;p__Verrucomicrobia;c__Verrucomicrobiae;o__Verrucomicrobiales;f__Verrucomicrobiaceae;g__Akkermansia"	TRUE	TRUE	FALSE